###################
###....##.#...#####
#####..#.@.......##
##............!####
##!...........#####
####..###.......###
##!.......!.....###
####...##......####
####...!......#####
##.............####
##...............##
##...............##
##........###....##
##....#.........###
##..#####.....#####
##...###........###
##....#.......#..##
##.............#.##
###.............###
###################
