###################
###.......#...#####
########.@.......##
##............!..##
##!...........#####
####..###.......###
##!............!.##
####...##......####
####...!......#####
##.............####
##....!..........##
##...............##
##........###....##
##....#.........###
#####.......#######
##...###........###
##.......!...##..##
##!............#.##
###............####
###################
