###################
###.......#...#####
###...##.@.......##
##............!..##
##!...........#####
####..##........###
##!............!.##
####....#.#....####
###....!......#####
##.............####
##....!..........##
##...............##
##...##..####....##
##....#.........###
#####.......#######
##..............###
##.......!...##..##
##!.....##.....#.##
###............####
###################
